1111111111111111111111111111111111111111111111111111111111111111111111111
1000000000000000000000000000000000000000000000000000000000000001111111111
1011111011111011111011111011111011111011111011111011111011111101111111111
1011111011111011111011111011111011111011111011111011111011111101111111111
1011111011111011111011111011111011111011111011111011111011111101111111111
1011111011111011111011111011111011111011111011111011111011111101111111111
1000000000000000000000000000000000000000000000000000000000000001111111111
1011111011111011111011111011111011111101111101111101111101111101111111111
1011111011111011111011111011111011111101111101111101111101111101111111111
1011111011111011111011111011111011111101111101111101111101111101111111111
1011111011111011111011111011111011111101111101111101111101111101111111111
1000000000000000000000000000000000000000000000000000000000000001111111111
1111111111111111111111111111110211011111111111111111111111111111111111111
1000000000000000000000000000000000000000000000000000000000000001111111111
1011111011111011111011111011111011111011111011111011111011111101111111111
1011111011111011111011111011111011111011111011111011111011111101111111111
1011111011111011111011111011111011111011111011111011111011111101111111111
1011111011111011111011111011111011111011111011111011111011111101111111111
1000000000000000000000000000000000000000000000000000000000000001111111111
1011111011111011111011111011111011111011111011111011111011111101111111111
1011111011111011111011111011111011111011111011111011111011111101111111111
1011111011111011111011111011111011111011111011111011111011111101111111111
1011111011111011111011111011111011111011111011111011111011111101111111111
1000000000000000000000000000000000000000000000000000000000000001111111111
1011111011111011111011111011111011111011111011111011111011111101111111111
1011111011111011111011111011111011111011111011111011111011111101111111111
1011111011111011111011111011111011111011111011111011111011111101111111111
1011111011111011111011111011111011111011111011111011111011111101111111111
1011111011111011111011111011111011111011111011111000111011111101111111111
1111111111111111111111111111111111111111111111111110111111111111111111111
1111111111111111111111111111111111111111111111110000111111111111111111111
1110000000000000000000000000000000000000000000110000000000000001111111111
1000000000000000000000000000000000000000000000010000000000000001111111111
1000000000000000000000040000000000000000000000000000000000000001111111111
1000000000000000000000000000000000000000000000000000000004000001111111111
1000000000000000000000000000000000300000000000000000000000000001111111111
1111111111111111111111111111111111111111111111111111111111111111111111111
1111111111111111111111111111111111111111111111111111111111111111111111111
1111111111111111111111111111111111111111111111111111111111111111111111111
1111111111111111111111111111111111111111111111111111111111111111111111111
1111111111111111111111111111111111111111111111111111111111111111111111111
1111111111111111111111111111111111111111111111111111111111111111111111111
1111111111111111111111111111111111111111111111111111111111111111111111111
1111111111111111111111111111111111111111111111111111111111111111111111111