11111111111111111111111111111111
11111111111111111111111111111111
11111111111111111111111111111111
11111111111111111111111111111111
10000000000011111111111111111111
10001000000000000000000001111111
10000002000001111000000001111111
10000000000001110000000000111111
11111110011111111111110111111111
11111110011111111111110001111111
10000000000000111111111111111111
10000000000000011111111111111111
11111111111111111111111111111111
11111111111111111111111111111111
11111111111111111111111111111111
11111111111111111111111111111111
11111111111111111111111111111111
11111111111111111111111111111111