11111111111111111111111111111111111111111111
10000000000000000000000000000000000000000001
10111011101110111011101110111011101110111101
10111011101110111011101110111011101110111101
10111011101110111011101110111011101110111101
10000000000000000000000000000000000000000001
10111011101110111011101111011101110111011101
10111011101110111011101111011101110111011101
10111011101110111011101111011101110111011101
10111011101110111011101111011101110111011101
10000000000000000000000000000000000000000001
11111111111111111111020111111111111111111111
10000000000000000000000000000000000000000001
10111011101110111011101110111011101110111101
10111011101110111011101110111011101110111101
10000000000000000000000000000000000000000001
10111011101110111011101110111011101110111101
10111011101110111011101110111011101110111101
10111011101110111011101110111011101110111101
10000000000000000000000000000000000000000001
10111011101110111011101110111011101110111101
10111011101110111011101110111011101110111101
10111011101110111011101110111011101110111101
10111011101110111011101110111011101110111101
10111011101110111011101110111011100010111101
11111111111111111111111111111111111011111111
11111111111111111111111111111000000001111111
11100000000000000000000000000000000000000001
10000000000000000000000000000000000000000001
10000000000000040000000000000000000000000001
10000000000000000000000000000000000000040001
10000000000000000000003000000000000000000001
11111111111111111111111111111111111111111111