1111111111111111111111111111111111111111111111111
1111111111111111111111111111111111111111111111111
1114000000001111100000111111111100000000000111111
1111110111101000001111111111111111000000000111111
1111500111100001111111115000011110000111111111111
1110001111111101111111400000011100001110001111111
1110011100111100001111111110000000011111100111111
1110111110011111111110000000000000000000000111111
1110111111011111111100000000011111111100011111111
1110111100000000011111111100111101110111011111111
1110000000111111003111000001111000000000011111111
1111001111111111111111111000000000010001111111111
1110001111111111111501111111111000000000111111111
1110000000000001111100001111000011001111114111111
1110001110010001111111100000000000000111110111111
1110001110101401110000001000010000000000000111111
1110501110001111111110000040200000011111110111111
1111111111011111111111111000000001111111110111111
1110000000000000000001111110000011111111115111111
1110011110111111100111110111001111111111111111111
1110000000000000000000000000000000000000004111111
1111111111111111111111111111111111111111111111111
1111111111111111111111111111111111111111111111111
1111111111111111111111111111111111111111111111111
1111111111111111111111111111111111111111111111111
1111111111111111111111111111111111111111111111111
1111111111111111111111111111111111111111111111111
1111111111111111111111111111111111111111111111111
1111111111111111111111111111111111111111111111111
1111111111111111111111111111111111111111111111111