111111111111111111111111111111111
111111111111111111111111111111111
111111100001111111111111111111111
100000000000111111111111111111111
100010000000000000000000011111111
140400200300010010000000011111111
100000000000011110000000001111111
111000000000000000000000111111111
111000001000011111111100011111111
100000000000001000000111111111111
100000000000001111111111111111111
111111100111111111111111111111111
111111100000000000000111111111111
111111100111100000000111111111111
111111100111100000000111111111111
111111100111111111111111111111111
111111100111111111111111111111111
111111100111111111111111111111111
111111100111111111111111111111111
111111100111111111111111111111111
111111100111111111111111111111111
111111100111111111111111111111111
111111100111111111111111111111111
111111100111111111111111111111111
111111100111111111111111111111111
111111100111111111111111111111111
111111100111111111111111111111111
111111100001111111111111111111111
111111400001111111111111111111111
111111000001111111111111111111111
111111000001111111111111111111111
111111111111111111111111111111111
111111111111111111111111111111111
111111111111111111111111111111111
111111111111111111111111111111111
111111111111111111111111111111111
111111111111111111111111111111111