111111111111111111111111111111111
111111111111111111111111111111111
111111100001111111111111111111111
100000000000111111111111111111111
100010000000000000000000011111111
100000200300011110000000011111111
100000000000011100000000001111111
111111100111111111111101111111111
111111100111111111111100011111111
100000000000001111111111111111111
100000000000000111111111111111111
111111100111111111111111111111111
111111100111111111111111111111111
111111100111111111111111111111111
111111100111111111111111111111111
111111100111111111111111111111111
111111100111111111111111111111111
111111100111111111111111111111111
111111100111111111111111111111111
111111100111111111111111111111111
111111100111111111111111111111111
111111100111111111111111111111111
111111100111111111111111111111111
111111100111111111111111111111111
111111100111111111111111111111111
111111100111111111111111111111111
111111100111111111111111111111111
111111100001111111111111111111111
111111400001111111111111111111111
111111000401111111111111111111111
111111000001111111111111111111111
111111111111111111111111111111111
111111111111111111111111111111111
111111111111111111111111111111111
111111111111111111111111111111111
111111111111111111111111111111111
111111111111111111111111111111111