11111111111111111111111111111111111111111111
11111111111111111111111111111111111111111111
11140000000011111000001111111111000000000001
11111101111010000011111111111111110000000001
11115001111000011111111150000111100001111111
11100011111111011111114000000111000011100011
11100111001111000011111111100000000111111001
11101111100111111111100000000000000000000001
11101111110111111111000000000111111111000111
11101111000000000111111111001111011101110111
11100000001111110031110000011110000000000111
11110011111111111111111110000000000100011111
11100011111111111115011111111110000000001111
11100000000000011111000011110000110011111141
11100011100100011111111000000000000001111101
11100011101014011100000010000100000000000001
11105011100011111111100000402000000111111101
11111111110111111111111110000000011111111101
11100000000000000000011111100000111111111151
11100111101111111001111101110011111111111111
11100000000000000000000000000000000000000041
11111111111111111111111111111111111111111111